37,23
0000000000010000010100010000000100000
0111110111110111010101011101110101111
0100010000000001010001000001000101000
0101111111110111010111111111110101010
0001000000010100010001010000000101010
1101011111010101111101010111111101010
0001010031010100000000010000000000010
0111010111011111111111111111111111010
0100010000010000000000010001000000010
0101110111010111111111011101011111110
0101010100010100000000000001000000010
0101010111110101111111011111011111011
0101000000000101000100010000000001000
0101111111111101010111110111111101010
0101000000000101010000000100010001010
0101011111110101011111111101011111010
0101010100010101000000000001000001010
0101010101010101111101111111111101010
0100000101010100000100000100000001010
0111110101010111110101110101011111010
0100010101010100010100010101000001010
1101011101010101010111110101010111110
2001000001000001010000000101010100000
Exit found in 824 steps.